#######################
#######################
#######################
#######################
#######...#############
#######..##.#.##############
#######.##..###..###########
#########........###########
########...@..#.....########
##########..###..##.########
#######..#..#....##.########
#######.##.##.#.##..########
#######.#......##..########
#######.#.....##..########
#######.###.###..########
#######...#.##..#######
#######..##.#..###..########
#######.##..##...##.########
#########........##.########
########......#..#..########
##########..###....#########
#######..#..#....###########
#######.##.##.#.############
#######.#......############
#######.#.....############
#######.#################
#######################
#######################
#######################
#######################